#########
##     ##
##  ~  ##
##     ##
#########
