# A      #
#        #
##########
#        #
#     a  #
