A       B
d       c
### #####
### #####
### #####

b       a
C       D
