#############
#A#a        #
# ######### #
#   #       #
# # # #######
# # #       #
# # ####### #
# #b#   #   #
# ### # # # #
#     # # # #
####### # # #
#         #B#
#############
