█████████████████
█ ⓑ           ⓐ █
█ A           B █
█               █
█████████████████
